111111111111
10B00C000001
10010B011001
101C11110B01
100E01P000C1
111111111111
