111111111111111111111111
10B00C0000010B00C0000001
10010B01100000010B011001
10B00C0000010B00C0000001
10010B01100000010B011001
101C11110B00000011110B01
100E01000C000001P00000C1
111111111111111111111111
