1111111
100C0B1
100B001
1C10B01
1E01PC1
1111111
